1 2 2 2 2 1 1  1  1  1  2   3 4 1 1 1
2 0 0 0 0 0 0  0  0  0  -4 -8 0 0 0 1
1 0 0 0 0 0 0  0  0  0  -3 -7 0 0 0 1
1 0 0 0 0 0 0  0  3  0  -2 -6 0 0 0 1
3 0 0 0 0 0 0 -1 -2  0   1 -5 0 0 0 1
2 0 0 0 0 0 0  0  0  0   5  0 0 0 0 1
1 1 1 1 1 1 1  1  1  1  1   1 1 1 1 1
